export var Hiken: Ability = {name: 'Hiken', desc: 'Turns the user\'s fist into flames and launches it towards the target.', cooldown: 8.0, projectileDamage: 20.0, projectileExplosion: 2, };
export var Higan: Ability = {name: 'Higan', desc: 'Turns the user\'s fingertips into flames and shoots bullets made of fire from them.', cooldown: 4.0, projectileDamage: 5.0, projectileNumber: 5, };
export var DaiEnkaiEntei: Ability = {name: 'Dai Enkai : Entei', desc: 'Amasses the user\'s flames into a gigantic fireball that the user hurls at the opponent.', cooldown: 25.0, chargeTime: 3.6, projectileDamage: 45.0, projectileExplosion: 7, };
export var Hidaruma: Ability = {name: 'Hidaruma', desc: 'Creates small green fireballs that set the target on fire.', cooldown: 6.0, };
export var Jujika: Ability = {name: 'Jujika', desc: 'Launches a cross-shaped column of fire at the opponent, leaving a cross of fire.', cooldown: 6.0, projectileDamage: 5.0, };
export var Enjomo: Ability = {name: 'Enjomo', desc: 'Creates a circle of fire around the user, burning everyone inside of it.', cooldown: 10.0, };
export var IceBlockPartisan: Ability = {name: 'Ice Block : Partisan', desc: 'Creates several spears of ice that the user hurls at the enemy.', cooldown: 7.0, projectileDamage: 10.0, projectileNumber: 3, onHitEffects: ['Slowness 5 seconds (-)', 'Mining Fatigue 5 seconds (-)'], };
export var IceSaber: Ability = {name: 'Ice Saber', desc: 'Creates a sharp blade made of solid ice.', };
export var IceAge: Ability = {name: 'Ice Age', desc: 'Freezes a large area around the user and everyone inside of it.', cooldown: 15.0, aoeEffects: ['Slowness 9 seconds (+)', 'Mining Fatigue 9 seconds (+)'], };
export var IceBall: Ability = {name: 'Ice Ball', desc: 'Creates a sphere of ice that surrounds the opponent.', cooldown: 6.0, projectileDamage: 5.0, onHitEffects: ['Slowness 5 seconds (-)', 'Mining Fatigue 5 seconds (-)'], };
export var IceTimeCapsule: Ability = {name: 'Ice Time Capsule', desc: 'A wave of ice is sent along the ground and freezes every enemy it hits.', cooldown: 15.0, };
export var IceBlockPheasant: Ability = {name: 'Ice Block : Pheasant', desc: 'Releases a massive wave of ice in the shape of a pheasant.', cooldown: 20.0, projectileDamage: 45.0, onHitEffects: ['Slowness 9 seconds (+)', 'Mining Fatigue 9 seconds (+)'], };
export var SpringDeathKnock: Ability = {name: 'Spring Death Knock', desc: 'By turning the user\'s arm into a spring and compressing it, they can launch a powerful punch.', cooldown: 6.0, projectileDamage: 20.0, };
export var SpringSnipe: Ability = {name: 'Spring Snipe', desc: 'Turning the user\'s forelegs into springs, they can launch themselves directly at the opponent.', cooldown: 5.0, chargeTime: 1.0, };
export var SpringHopper: Ability = {name: 'Spring Hopper', desc: 'Turning the userps legs into springs, which launches them into the air.', cooldown: 0.6, chargeTime: 0.5, };
export var YatanoKagami: Ability = {name: 'Yata no Kagami', desc: 'Uses light to instantly teleport the user to their desired location.', cooldown: 4.0, };
export var AmanoMurakumo: Ability = {name: 'Ama no Murakumo', desc: 'Focuses light in the user\'s hand to create a sword.', };
export var YasakaninoMagatama: Ability = {name: 'Yasakani no Magatama', desc: 'Fires a torrent of deadly light particles, causing huge destruction.', cooldown: 2.5, projectileDamage: 2.0, projectileNumber: 12, projectileExplosion: 1, };
export var Amaterasu: Ability = {name: 'Amaterasu', desc: 'Creates an immense beam of light, which causes massive damage.', cooldown: 15.0, chargeTime: 2.0, projectileDamage: 35.0, projectileExplosion: 6, };
export var Flash: Ability = {name: 'Flash', desc: 'The user creates a bright flash of light, blinding their opponents.', cooldown: 5.0, aoeEffects: ['Blindness 6 seconds (+)', 'Slowness 6 seconds (+)'], };
export var ShishanoTe: Ability = {name: 'Shisha no Te', desc: 'Shoots invisible projectiles that explode upon impact.', cooldown: 3.0, projectileDamage: 5.0, projectileExplosion: 3, };
export var Skatting: Ability = {name: 'Skatting', desc: 'Turns the user\'s entire body invisible.', selfEffects: ['Invisibility 2 seconds (-)'], };
export var Room: Ability = {name: 'Room', desc: 'Creates a spherical space around the user, in which they can manipulate anything with other skills.', cooldown: 5.0, };
export var Mes: Ability = {name: 'Mes', desc: 'Removes the heart of the user\'s target, which they can then damage to hurt the opponent.', cooldown: 5.0, };
export var CounterShock: Ability = {name: 'Counter Shock', desc: 'Releases a strong electrical current, which shocks the opponent.', cooldown: 10.0, };
export var GammaKnife: Ability = {name: 'Gamma Knife', desc: 'Creates a blade of gamma radiation, which massively damages the opponent\'s organs', cooldown: 30.0, projectileDamage: 100.0, };
export var Takt: Ability = {name: 'Takt', desc: 'Lifts all entities inside ROOM, making them unable to move.', cooldown: 10.0, };
export var Shambles: Ability = {name: 'Shambles', desc: 'The user randomly switches the positions of all entities inside ROOM.', cooldown: 8.0, };
export var InjectionShot: Ability = {name: 'Injection Shot', desc: 'While holding a weapon, the user charges at the enemy, leaving them poisoned and confused.', cooldown: 15.0, };
export var ElThor: Ability = {name: 'El Thor', desc: 'Focuses the user\'s electricity to strike the opponent with lightning from above.', cooldown: 8.0, chargeTime: 6.0, };
export var VoltVari: Ability = {name: 'Volt Vari', desc: 'Creates a concentrated ball of lightning, which varies in power.', cooldown: 3.0, chargeTime: 10.0, };
export var Raigo: Ability = {name: 'Raigo', desc: 'Creates a huge cloud filled with electricity, which causes massive damage.', cooldown: 30.0, projectileDamage: 120.0, projectileExplosion: 30, };
export var Kari: Ability = {name: 'Kari', desc: 'Creates an electrical current around the user, which then explodes.', cooldown: 15.0, chargeTime: 7.0, };
export var Sango: Ability = {name: 'Sango', desc: 'Launches a huge concentrated chunk of electricity at the opponent.', cooldown: 10.0, projectileDamage: 15.0, projectileNumber: 5, };
export var WhiteOut: Ability = {name: 'White Out', desc: 'Shoots clouds of smoke to engulf the opponent and trap them.', cooldown: 4.0, projectileDamage: 5.0, onHitEffects: ['Slowness 10 seconds (+)', 'Mining Fatigue 10 seconds (+)', 'Jump Boost 10 seconds (-)'], };
export var WhiteSnake: Ability = {name: 'White Snake', desc: 'Launches a long dense smoke cloud in the shape of a snake to grab the opponent and damage them.', cooldown: 5.0, projectileDamage: 30.0, onHitEffects: ['Poison 5 seconds (-)'], };
export var WhiteLauncher: Ability = {name: 'White Launcher', desc: 'Transforms the user into smoke and launches them forward.', cooldown: 5.0, chargeTime: 1.0, };
export var WhiteStrike: Ability = {name: 'White Strike', desc: '', cooldown: 35.0, aoeEffects: ['Slowness 13 seconds (+)', 'Mining Fatigue 13 seconds (+)', 'Jump Boost 13 seconds (-)'], };
export var PadHo: Ability = {name: 'Pad Ho', desc: 'Launches a paw-shaped shockwave at the opponent.', cooldown: 8.0, projectileDamage: 10.0, projectileExplosion: 1, };
export var TsuppariPadHo: Ability = {name: 'Tsuppari Pad Ho', desc: 'Similar to "Pad Ho", but fires a barrage of shockwaves.', cooldown: 10.0, projectileDamage: 15.0, projectileExplosion: 1, };
export var Hanpatsu: Ability = {name: 'Hanpatsu', desc: 'Anyone the user punches gets sent flying far into the air.', cooldown: 4.0, };
export var UrsusShock: Ability = {name: 'Ursus Shock', desc: 'The user compresses air and sends it towards the opponent to create a massive explosion.', cooldown: 15.0, chargeTime: 2.0, projectileDamage: 50.0, projectileExplosion: 6, };
export var KickBomb: Ability = {name: 'Kick Bomb', desc: 'The user kicks their opponent, detonating their leg on impact.', cooldown: 7.0, };
export var NoseFancyCannon: Ability = {name: 'Nose Fancy Cannon', desc: 'Shoots dried mucus at the opponent, which explodes on impact.', cooldown: 3.0, projectileDamage: 10.0, projectileExplosion: 3, };
export var Kaishin: Ability = {name: 'Kaishin', desc: 'The user cracks the air, which launches a small but powerful explosion towards the opponent.', cooldown: 7.0, projectileDamage: 50.0, projectileExplosion: 1, };
export var Kabutowari: Ability = {name: 'Kabutowari', desc: 'The user punches the air and creates a massive explosion around themselves.', cooldown: 7.0, };
export var ShimaYurashi: Ability = {name: 'Shima Yurashi', desc: 'Launches a powerful explosion which spreads towards the opponent.', cooldown: 11.0, projectileDamage: 20.0, projectileExplosion: 2, };
export var Gekishin: Ability = {name: 'Gekishin', desc: 'The user creates a tremor while punching the enemy, inflicting massive damage.', cooldown: 30.0, };
export var Doppelman: Ability = {name: 'Doppelman', desc: 'Creates a living version of the user\'s shadow to help them fight.', cooldown: 20.0, };
export var BrickBat: Ability = {name: 'Brick Bat', desc: 'Launches bats created from the user\'s shadow at the the opponent.', cooldown: 4.0, projectileDamage: 10.0, projectileNumber: 2, };
export var BlackBox: Ability = {name: 'Black Box', desc: 'Encases and suffocates the opponent in a box made of shadows.', cooldown: 6.0, };
export var TsunoTokage: Ability = {name: 'Tsuno-Tokage', desc: 'The user creates a lizard-like shadow under his opponent, which pierces them from below.', cooldown: 10.0, };
export var Barjan: Ability = {name: 'Barjan', desc: 'Launches a crescent-shaped wave of sand at the opponent, that dehydrates them.', cooldown: 5.0, projectileDamage: 15.0, onHitEffects: ['Hunger 21 seconds (+)'], };
export var Sables: Ability = {name: 'Sables', desc: 'The user launches a compressed sandstorm at the opponent, which sends them flying.', cooldown: 3.0, };
export var GroundDeath: Ability = {name: 'Ground Death', desc: 'Dries out the surroundings and suffucates all nearby opponents in sand.', cooldown: 15.0, };
export var DesertSpada: Ability = {name: 'Desert Spada', desc: 'The user extends their sand along the ground, splitting it and suffocating everything it its path. ', cooldown: 7.0, };
export var DesertEncierro: Ability = {name: 'Desert Encierro', desc: '', cooldown: 10.0, };
export var DesertGirasole: Ability = {name: 'Desert Girasole', desc: '', cooldown: 25.0, chargeTime: 5.0, };
export var BakuretsuKazan: Ability = {name: 'Bakuretsu Kazan', desc: 'By spreading magma to the surroundings, the user turns everything into lava.', cooldown: 15.0, };
export var RyuseiKazan: Ability = {name: 'Ryusei Kazan', desc: 'Functions like "Dai Funka", but multiple fists are launched at the opponent.', cooldown: 12.0, projectileDamage: 10.0, };
export var Meigo: Ability = {name: 'Meigo', desc: 'The user transforms their arm into magma and thrusts it at the opponent.', cooldown: 10.0, projectileDamage: 40.0, };
export var DaiFunka: Ability = {name: 'Dai Funka', desc: 'The user covers their fist in lava and fires it at the opponent.', cooldown: 8.0, projectileDamage: 20.0, };
export var DoruDoruArtsMori: Ability = {name: 'Doru Doru Arts : Mori', desc: 'The user fires a harpoon made of wax at the opponent.', cooldown: 3.0, projectileDamage: 15.0, };
export var DoruDoruArtsKen: Ability = {name: 'Doru Doru Arts : Ken', desc: 'The user uses hardened wax to create a sword.', };
export var CandleWall: Ability = {name: 'Candle Wall', desc: 'Creates a wax wall to protect the user.', cooldown: 4.0, };
export var CandleHouse: Ability = {name: 'Candle House', desc: 'Creates a big house-like structure made of wax, to protect the user.', cooldown: 30.0, };
export var CandleLock: Ability = {name: 'Candle Lock', desc: 'Traps the opponent\'s feet in hardened wax, which makes them unable to move.', cooldown: 15.0, projectileDamage: 6.0, onHitEffects: ['Slowness 17 seconds (+)', 'Mining Fatigue 17 seconds (+)', 'Jump Boost 9 seconds (-)'], };
export var Hydra: Ability = {name: 'Hydra', desc: 'Launches a dragon made out of liqiud poison at the opponent.', cooldown: 8.0, projectileDamage: 30.0, onHitEffects: ['Poison 21 seconds (+)'], };
export var ChloroBall: Ability = {name: 'Chloro Ball', desc: 'The user spits a bubble made of poison towards the enemy, which leaves poison on the ground.', cooldown: 6.0, projectileDamage: 10.0, onHitEffects: ['Poison 10 seconds (+)'], };
export var DokuFugu: Ability = {name: 'Doku Fugu', desc: 'Shoots multiple poisonous bullets at the opponent.', cooldown: 8.0, projectileDamage: 15.0, projectileNumber: 1, onHitEffects: ['Poison 10 seconds (+)'], };
export var VenomRoad: Ability = {name: 'Venom Road', desc: 'The user fires a Hydra at the target location and transports there through its path.', cooldown: 8.0, projectileDamage: 20.0, onHitEffects: ['Poison 21 seconds (+)'], };
export var DokuGumo: Ability = {name: 'Doku Gumo', desc: 'Creates a dense cloud of poisonous smoke, which moves along with the user and poisons and blinds everyone inside.', cooldown: 30.0, };
export var VenomDemon: Ability = {name: 'Venom Demon', desc: 'The user coats himself in layers of strong corrosive venom, becoming a Venom Demon and leaving a highly poisonou trail.', cooldown: 40.0, };
export var GasRobe: Ability = {name: 'Gas Robe', desc: 'Launches a cloud of poison at the opponent.', cooldown: 6.0, projectileDamage: 10.0, projectileNumber: 3, };
export var BlueSword: Ability = {name: 'Blue Sword', desc: 'The user fills a hilt with lamable gas, them sets it on fire to create a sword.', };
export var Gastille: Ability = {name: 'Gastille', desc: 'Shoots a beam of poisonous gas from the user\'s mouth, that explodes on impact.', cooldown: 7.0, projectileDamage: 10.0, projectileNumber: 3, projectileExplosion: 1, onHitEffects: ['Poison 21 seconds (+)'], };
export var Gastanet: Ability = {name: 'Gastanet', desc: 'The user fills castanets with unstable gas, whcih causes an explosion when slammed together.', cooldown: 6.0, };
export var Karakuni: Ability = {name: 'Karakuni', desc: 'Removes the oxygen around the user, suffocating everyone in the vicinity.', cooldown: 20.0, };
export var Kamakura: Ability = {name: 'Kamakura', desc: 'Creates an igloo-like snow barrier around the user.', cooldown: 6.0, };
export var TabiraYuki: Ability = {name: 'Tabira Yuki', desc: 'The user creates a sword made of solid hardened snow.', };
export var YukiRabi: Ability = {name: 'Yuki Rabi', desc: 'Launches numerous hardened snowballs, that have the shape of a rabbit\'s head.', cooldown: 2.0, projectileDamage: 5.0, projectileNumber: 10, onHitEffects: ['Slowness 3 seconds (+)'], };
export var KamakuraJussoshi: Ability = {name: 'Kamakura Jussoshi', desc: 'Like "Kamakura", but creates a multi-layered snow barrier.', cooldown: 18.0, };
export var Fubuki: Ability = {name: 'Fubuki', desc: 'The user releases an extremely cold stream of snow that spreads into the air around them.', cooldown: 12.0, };
export var YukiGaki: Ability = {name: 'Yuki Gaki', desc: 'The user creates a huge wall of snow.', cooldown: 8.0, };
export var Parasite: Ability = {name: 'Parasite', desc: 'The user binds the opponent with a string that renders them immobile.', cooldown: 5.0, };
export var SoranoMichi: Ability = {name: 'Sora no Michi', desc: 'The user creates strings under their feet to launch themselves into the air.', cooldown: 1.0, };
export var Overheat: Ability = {name: 'Overheat', desc: 'The user shoots a rope made of heated strings at the opponent, exploding upon impact.', cooldown: 8.0, projectileDamage: 20.0, projectileExplosion: 3, };
export var Tamaito: Ability = {name: 'Tamaito', desc: 'The user shoots a small bundle of strings, acting like a bullet.', cooldown: 5.0, projectileDamage: 6.0, };
export var KumonoSugaki: Ability = {name: 'Kumo no Sugaki', desc: 'Creates a huge web that protects the user from any attack.', cooldown: 10.0, selfEffects: ['Resistance 2 seconds (+)', 'Slowness 2 seconds (+)', 'Mining Fatigue 2 seconds (+)', 'Jump Boost 2 seconds (-)'], };
export var Torikago: Ability = {name: 'Torikago', desc: 'Creates an indestructible dome made of strings, that damage anyone who toches then', cooldown: 5.0, };
export var Barrier: Ability = {name: 'Barrier', desc: 'The user creates an impenetrable wall that shields them from attacks.', cooldown: 0.5, };
export var BarrierBall: Ability = {name: 'Barrier Ball', desc: 'The user creates a spherical barrier around them, shielding them from attacks.', cooldown: 0.5, };
export var BarrierCrash: Ability = {name: 'Barrier Crash', desc: 'Launches a barrier towards the opponent, smashing it against them.', cooldown: 3.0, projectileDamage: 15.0, };
export var BariBarinoPistol: Ability = {name: 'Bari Bari no Pistol', desc: 'The user shapes a barrier aroud their fist, which greatly increases the power of a punch.', cooldown: 5.0, };
export var BarrierbilityStairs: Ability = {name: 'Barrierbility Stairs', desc: 'By shaping the Barrier, the user can create stairs.', cooldown: 30.0, };
export var NegativeHollow: Ability = {name: 'Negative Hollow', desc: 'The user launches a ghost that drains the target\'s will.', cooldown: 6.0, projectileDamage: 10.0, onHitEffects: ['Nausea 9 seconds (+)', 'Slowness 9 seconds (+)'], };
export var MiniHollow: Ability = {name: 'Mini Hollow', desc: 'Launches small ghosts at the opponent, exploding upon impact.', cooldown: 3.0, projectileDamage: 2.0, projectileNumber: 1, projectileExplosion: 2, onHitEffects: ['Nausea 5 seconds (-)', 'Slowness 5 seconds (-)'], };
export var TokuHollow: Ability = {name: 'Toku Hollow', desc: 'Creates a huge ghost that causes a massive explosion upon impact.', cooldown: 10.0, projectileDamage: 10.0, projectileExplosion: 7, onHitEffects: ['Nausea 17 seconds (+)', 'Slowness 17 seconds (+)'], };
export var Todoroki: Ability = {name: 'Todoroki', desc: 'The user shouts and creates a powerful sound blast.', cooldown: 20.0, projectileDamage: 15.0, projectileNumber: 1, };
export var NoroNoroBeam: Ability = {name: 'Noro Noro Beam', desc: 'Shoots a beam of photons at the opponent, completely slowing them down.', cooldown: 5.0, };
export var NoroNoroBeamSword: Ability = {name: 'Noro Noro Beam Sword', desc: 'Focuses photons inside a hilt to create a sword.', };
export var KyubiRush: Ability = {name: 'Kyubi Rush', desc: 'While the opponent is slowed, the user delivers a series of punches, which hits the opponent all at once.', cooldown: 7.0, };
export var DarkMatter: Ability = {name: 'Dark Matter', desc: 'Launches a ball of darkness that engulfs the opponent.', cooldown: 12.0, };
export var Liberation: Ability = {name: 'Liberation', desc: 'The user expells everything sucked up by the "Black Hole" at the target location.', cooldown: 5.0, };
export var BlackHole: Ability = {name: 'Black Hole', desc: 'The user spreads darkness over the target area, which engulfs anyone and anything inside of it.', cooldown: 7.0, };
export var BlackWorld: Ability = {name: 'Black World', desc: 'The user spreads darkness to the surroundings, blinding enemies and creating pillars made of Darkness.', cooldown: 25.0, aoeEffects: ['Slowness 9 seconds (+)', 'Mining Fatigue 9 seconds (+)', 'Blindness 9 seconds (+)'], };
export var GomuGomunoPistol: Ability = {name: 'Gomu Gomu no Pistol', desc: 'The user stretches their arm to hit the opponent.', };
export var GomuGomunoBazooka: Ability = {name: 'Gomu Gomu no Bazooka', desc: 'The user stretches their arms to send the opponent flying by hitting them with both palms', chargeTime: 0.5, };
export var GomuGomunoRocket: Ability = {name: 'Gomu Gomu no Rocket', desc: '', cooldown: 8.0, projectileDamage: 6.0, };
export var GomuGomunoGatling: Ability = {name: 'Gomu Gomu no Gatling', desc: '', };
export var GearSecond: Ability = {name: 'Gear Second', desc: 'By speding up their blood flow, the user gains strength, speed and mobility.', cooldown: 60.0, };
export var GearThird: Ability = {name: 'Gear Third', desc: 'By blowing air and inflating their body, the user\'s attacks get bigger and gain incredible strength.', cooldown: 90.0, };
export var GearFourth: Ability = {name: 'Gear Fourth', desc: '', cooldown: 300.0, };
export var PowerPoint: Ability = {name: 'Power Point', desc: 'The user transforms into a half-bison hybrid, which focuses on strength, Allows the user to use \'Kokutei Cross\' and \'Fiddle Banff\'', cooldown: 1.0, };
export var SpeedPoint: Ability = {name: 'Speed Point', desc: '', cooldown: 1.0, };
export var FiddleBanff: Ability = {name: 'Fiddle Banff', desc: 'The transformed user dashes towards the opponent to crash against them with great power.', cooldown: 7.0, };
export var KokuteiCross: Ability = {name: 'Kokutei Cross', desc: 'The transformed user crosses their hooves to hit the opponent.', cooldown: 7.0, };
export var PhoenixPoint: Ability = {name: 'Phoenix Point', desc: 'The user fully transforms into a phoenix, allowing them to fly at great speed. Allows the user to use both \'Phoenix Goen\' and \'Tensei no Soen\'', cooldown: 1.0, };
export var HybridPoint: Ability = {name: 'Hybrid Point', desc: 'The user transforms into a phoenix-human hybrid, which allows them to fly. Allows the user to use \'Phoenix Goen\' ', cooldown: 1.0, };
export var BlueFlamesofResurrection: Ability = {name: 'Blue Flames of Resurrection', desc: 'Blue phoenix flames grant the user regeneration.', cooldown: 20.0, selfEffects: ['Regeneration 3 seconds (+)'], };
export var FlameofRestoration: Ability = {name: 'Flame of Restoration', desc: 'Uses the blue flames to heal the target.', cooldown: 3.0, };
export var PhoenixGoen: Ability = {name: 'Phoenix Goen', desc: 'Launches a powerful fiery shockwave made of blue flames at the target.', cooldown: 10.0, projectileDamage: 12.0, };
export var TenseinoSoen: Ability = {name: 'Tensei no Soen', desc: 'While in the air, the user amasses spiraling flames, then slams into the ground, releasing a massive shockwave.', cooldown: 30.0, chargeTime: 5.0, };
export var Soru: Ability = {name: 'Soru', desc: 'Allows the user to move at an extremely high speed.', selfEffects: ['Speed 2 seconds (+)'], };
export var Tekkai: Ability = {name: 'Tekkai', desc: 'Hardens the user\'s body to protect themselves, but they\'re unable to move.', selfEffects: ['Resistance 2 seconds (+)', 'Slowness 2 seconds (+)', 'Mining Fatigue 2 seconds (+)', 'Jump Boost 2 seconds (-)'], };
export var Geppo: Ability = {name: 'Geppo', desc: 'The user kicks the air beneath them to launch themselves into the air.', cooldown: 0.9, };
export var Rankyaku: Ability = {name: 'Rankyaku', desc: 'By kicking at a very high speed, the user launches an air blade at the opponent.', cooldown: 9.0, projectileDamage: 20.0, projectileExplosion: 5, };
export var Shigan: Ability = {name: 'Shigan', desc: 'The user thrusts their finger at the opponent, to pierce them.', cooldown: 5.0, };
export var Kamie: Ability = {name: 'Kamie', desc: 'Maked the user\'s body flexible in order to avoid attacks.', cooldown: 10.0, selfEffects: ['Resistance 1 second (+)'], };
export var Uchimizu: Ability = {name: 'Uchimizu', desc: 'The user hurls big and fast water droplets at the opponent.', cooldown: 5.0, projectileDamage: 5.0, projectileNumber: 6, };
export var Murasame: Ability = {name: 'Murasame', desc: 'The user fires densely compressed shark-shaped waterbullet at the opponent.', cooldown: 8.0, projectileDamage: 25.0, };
export var SamehadaShotei: Ability = {name: 'Samehada Shotei', desc: 'The user concentrates their power to their palms, protecting themselves from attacks.', selfEffects: ['Resistance 1 second (+)', 'Slowness 1 second (+)', 'Jump Boost 2 seconds (-)'], };
export var KarakusagawaraSeiken: Ability = {name: 'Karakusagawara Seiken', desc: 'The user punches the air, which sends a shockwave through water vapor in the air.', cooldown: 25.0, };
export var KachiageHaisoku: Ability = {name: 'Kachiage Haisoku', desc: 'The user delivers a powerful kick to the opponent\'s chin.', cooldown: 15.0, };
export var FreshFire: Ability = {name: 'Fresh Fire', desc: 'The user heats up and breathes fire like a flamethrower at the opponent.', cooldown: 1.5, };
export var ColaOverdrive: Ability = {name: 'Cola Overdrive', desc: 'The user absorbs all of their cola at once to boost their physical abilities.', cooldown: 7.0, selfEffects: ['Speed 9 seconds (-)', 'Strength 9 seconds (+)'], };
export var RadicalBeam: Ability = {name: 'Radical Beam', desc: 'After charging, the user launches a powerful beam of energy at the opponent.', cooldown: 5.0, projectileDamage: 10.0, projectileExplosion: 4, };
export var StrongRight: Ability = {name: 'Strong Right', desc: 'The user punches the opponent with a metal fist.', cooldown: 2.5, projectileDamage: 20.0, };
export var CoupdeVent: Ability = {name: 'Coup de Vent', desc: 'Launches a powerful blast of compressed air that blows the opponent away.', cooldown: 10.0, chargeTime: 1.5, projectileDamage: 10.0, };
export var KenbunshokuHaki: Ability = {name: 'Kenbunshoku Haki', desc: 'Allows the user to sense the presence of others, pointing them to the opponent, Can also locate invisible mobs and players.', };
export var BusoshokuHaki: Ability = {name: 'Busoshoku Haki', desc: 'The user forms an invisible armor around themselves using their willpower, By using this form of Haki, the user can damage Logias.', };
export var ShiShishiSonson: Ability = {name: 'Shi Shishi Sonson', desc: 'The user dashes forward and rapidly slashes the opponent.', cooldown: 7.0, };
export var SanbyakurokujuPoundHo: Ability = {name: 'Sanbyakurokuju Pound Ho', desc: 'The user launches a powerful slash, causing great destruction.', cooldown: 5.0, projectileDamage: 20.0, };
export var Yakkodori: Ability = {name: 'Yakkodori', desc: 'Launches a crescent moon-shaped slash, which destroys everything in its path.', cooldown: 5.0, projectileDamage: 10.0, };
export var OTatsumaki: Ability = {name: 'O Tatsumaki', desc: 'By spinning, the user creates a small tornado, which slashes and weakens nearby opponents.', cooldown: 7.0, };
export var KaenBoshi: Ability = {name: 'Kaen Boshi', desc: 'Fires a flaming pellet, that sets the target on fire.', cooldown: 10.0, projectileDamage: 12.0, };
export var KemuriBoshi: Ability = {name: 'Kemuri Boshi', desc: 'On impact releases smoke that poisons and confuses targets.', cooldown: 10.0, projectileDamage: 6.0, };
export var RenpatsuNamariBoshi: Ability = {name: 'Renpatsu Namari Boshi', desc: 'Lets the user fire a barrage of exploding shots.', cooldown: 15.0, projectileDamage: 4.0, projectileNumber: 3, projectileExplosion: 1, };
export var SakuretsuSabotenBoshi: Ability = {name: 'Sakuretsu Saboten Boshi', desc: 'The fired projectile explodes on impact and creates cacti arond the target, to trap them.', cooldown: 12.0, projectileDamage: 6.0, projectileExplosion: 2, };
export var SagarinoRyusei: Ability = {name: 'Sagari no Ryusei', desc: '', cooldown: 20.0, projectileDamage: 50.0, projectileExplosion: 20, };
export var Juryoku: Ability = {name: 'Juryoku', desc: '', cooldown: 10.0, };
export var Moko: Ability = {name: 'Moko', desc: '', cooldown: 10.0, };
export var BakuMunch: Ability = {name: 'Baku Munch', desc: '', cooldown: 5.0, };
export var BeroCannon: Ability = {name: 'Bero Cannon', desc: '', cooldown: 5.0, };
export var BakuTsuiho: Ability = {name: 'Baku Tsuiho', desc: '', cooldown: 10.0, chargeTime: 15.0, };
